{
  "maps": [
    {
      "id": "ch1_floor1",
      "name": "잊혀진 숲 - 입구",
      "chapter": 1,
      "floor": 1,
      "width": 25,
      "height": 20,
      "layout": [
        "#########################",
        "#.......................#",
        "#.......................#",
        "#..###...........###....#",
        "#..#.#...........#.#....#",
        "#..#.#....P......#.#....#",
        "#..###...........###....#",
        "#.......................#",
        "#.......................#",
        "#....M.......M..........#",
        "#.......................#",
        "#..........###..........#",
        "#..........#T#..........#",
        "#..........###..........#",
        "#.......................#",
        "#....M.............M....#",
        "#.......................#",
        "#.......................E",
        "#.......................#",
        "#########################"
      ],
      "spawnPoints": [
        {"x": 5, "y": 9, "type": "monster", "monsterId": "goblin"},
        {"x": 13, "y": 9, "type": "monster", "monsterId": "goblin"},
        {"x": 5, "y": 15, "type": "monster", "monsterId": "muddy"},
        {"x": 19, "y": 15, "type": "monster", "monsterId": "goblin"},
        {"x": 12, "y": 12, "type": "chest", "itemId": "health_potion"}
      ],
      "playerSpawn": [12, 5],
      "exitPoint": [24, 17],
      "legend": {
        "#": "wall",
        ".": "floor",
        "P": "player_spawn",
        "M": "monster_spawn",
        "T": "treasure",
        "E": "exit",
        "N": "npc",
        "B": "boss"
      }
    },
    {
      "id": "ch1_floor2",
      "name": "잊혀진 숲 - 깊은 숲",
      "chapter": 1,
      "floor": 2,
      "width": 30,
      "height": 25,
      "layout": [
        "##############################",
        "#P...........................#",
        "#............................#",
        "#..####.........#####........#",
        "#..#..#.........#...#........#",
        "#..#..#....M....#.T.#...M....#",
        "#..####.........#####........#",
        "#............................#",
        "#............................#",
        "#.......M..........M.........#",
        "#............................#",
        "#..####..................####.",
        "#..#..#..................#..#.",
        "#..#..#..................#..#.",
        "#..####..................####.",
        "#............................#",
        "#.....M...........M..........#",
        "#............................#",
        "#........#########...........#",
        "#........#.......#...........#",
        "#........#...N...#...........#",
        "#........#.......#...........#",
        "#........####E####...........#",
        "#............................#",
        "##############################"
      ],
      "spawnPoints": [
        {"x": 11, "y": 5, "type": "monster", "monsterId": "goblin"},
        {"x": 22, "y": 5, "type": "monster", "monsterId": "skelet"},
        {"x": 8, "y": 9, "type": "monster", "monsterId": "goblin"},
        {"x": 18, "y": 9, "type": "monster", "monsterId": "goblin"},
        {"x": 6, "y": 16, "type": "monster", "monsterId": "skelet"},
        {"x": 15, "y": 16, "type": "monster", "monsterId": "imp"},
        {"x": 16, "y": 5, "type": "chest", "itemId": "mana_potion"},
        {"x": 13, "y": 20, "type": "npc"}
      ],
      "playerSpawn": [1, 1],
      "exitPoint": [13, 22]
    },
    {
      "id": "ch1_boss",
      "name": "잊혀진 숲 - 수호자의 방",
      "chapter": 1,
      "floor": 3,
      "width": 20,
      "height": 20,
      "layout": [
        "####################",
        "#..................#",
        "#..................#",
        "#..P...............#",
        "#..................#",
        "#..................#",
        "#..................#",
        "#..................#",
        "#..................#",
        "#.........B........#",
        "#..................#",
        "#..................#",
        "#..................#",
        "#..................#",
        "#..................#",
        "#..................#",
        "#..................#",
        "#..................#",
        "#...........T......#",
        "####################"
      ],
      "spawnPoints": [
        {"x": 10, "y": 9, "type": "boss", "monsterId": "boss_forest_guardian"},
        {"x": 12, "y": 18, "type": "chest", "itemId": "forest_key"}
      ],
      "playerSpawn": [3, 3],
      "exitPoint": [17, 18]
    },
    {
      "id": "ch2_floor1",
      "name": "심연의 동굴 - 입구",
      "chapter": 2,
      "floor": 1,
      "width": 30,
      "height": 25,
      "layout": [
        "##############################",
        "#P...........................#",
        "#............................#",
        "#....####..........####......#",
        "#....#~~#..........#~~#......#",
        "#....#~~#....M.....#~~#......#",
        "#....####..........####......#",
        "#............................#",
        "#.......M............M.......#",
        "#............................#",
        "#..###.................###...#",
        "#..#.#.................#.#...#",
        "#..#.#........T........#.#...#",
        "#..###.................###...#",
        "#............................#",
        "#............................#",
        "#.....M..............M.......#",
        "#............................#",
        "#............................#",
        "#..####..............####....#",
        "#..#~~#..............#~~#....#",
        "#..#~~#......N.......#~~#....#",
        "#..####..............####....#",
        "#...................E........#",
        "##############################"
      ],
      "spawnPoints": [
        {"x": 13, "y": 5, "type": "monster", "monsterId": "skelet"},
        {"x": 8, "y": 8, "type": "monster", "monsterId": "skelet"},
        {"x": 21, "y": 8, "type": "monster", "monsterId": "imp"},
        {"x": 6, "y": 16, "type": "monster", "monsterId": "chort"},
        {"x": 19, "y": 16, "type": "monster", "monsterId": "skelet"},
        {"x": 14, "y": 12, "type": "chest", "itemId": "health_potion_large"},
        {"x": 13, "y": 21, "type": "npc"}
      ],
      "playerSpawn": [1, 1],
      "exitPoint": [20, 23],
      "legend": {
        "~": "water"
      }
    },
    {
      "id": "ch2_floor2",
      "name": "심연의 동굴 - 어둠의 심연",
      "chapter": 2,
      "floor": 2,
      "width": 35,
      "height": 30,
      "layout": [
        "###################################",
        "#P.........#.............#........#",
        "#..........#.............#........#",
        "#..........#.....M.......#........#",
        "#..........#.............#........#",
        "####.###...######.########...###.##",
        "#...............................M.#",
        "#..................................#",
        "#..M...............................#",
        "#..................................#",
        "#########.###########.#############",
        "#..................................#",
        "#..........#.............#........#",
        "#..........#.....T.......#........#",
        "#..........#.............#....M...#",
        "#..........#.............#........#",
        "####.###...######.########...###.##",
        "#..................................#",
        "#..M...............................#",
        "#..................................#",
        "#...............................M.#",
        "#########.###########.#############",
        "#..................................#",
        "#..........#.............#........#",
        "#..........#.....N.......#........#",
        "#..........#.............#........#",
        "#..........#.............#........#",
        "####.###...######E########...###.##",
        "#..................................#",
        "###################################"
      ],
      "spawnPoints": [
        {"x": 17, "y": 3, "type": "monster", "monsterId": "skelet"},
        {"x": 31, "y": 6, "type": "monster", "monsterId": "chort", "isElite": true},
        {"x": 3, "y": 8, "type": "monster", "monsterId": "imp"},
        {"x": 28, "y": 14, "type": "monster", "monsterId": "skelet"},
        {"x": 3, "y": 18, "type": "monster", "monsterId": "chort"},
        {"x": 31, "y": 20, "type": "monster", "monsterId": "imp"},
        {"x": 17, "y": 13, "type": "chest", "itemId": "mana_potion_large"},
        {"x": 17, "y": 24, "type": "npc"}
      ],
      "playerSpawn": [1, 1],
      "exitPoint": [17, 27]
    },
    {
      "id": "ch2_boss",
      "name": "심연의 동굴 - 공포의 심장",
      "chapter": 2,
      "floor": 3,
      "width": 25,
      "height": 25,
      "layout": [
        "#########################",
        "#.......................#",
        "#.......................#",
        "#..P....................#",
        "#.......................#",
        "#.......................#",
        "#.......................#",
        "#####.............#####.#",
        "#...#.............#...#.#",
        "#...#.............#...#.#",
        "#####.............#####.#",
        "#.......................#",
        "#...........B...........#",
        "#.......................#",
        "#####.............#####.#",
        "#...#.............#...#.#",
        "#...#.............#...#.#",
        "#####.............#####.#",
        "#.......................#",
        "#.......................#",
        "#.......................#",
        "#.......................#",
        "#..............T........#",
        "#.......................#",
        "#########################"
      ],
      "spawnPoints": [
        {"x": 12, "y": 12, "type": "boss", "monsterId": "boss_cave_horror"},
        {"x": 15, "y": 22, "type": "chest", "itemId": "boss_heart"}
      ],
      "playerSpawn": [3, 3],
      "exitPoint": [22, 22]
    }
  ],
  "tileTypes": {
    "#": {"type": "wall", "solid": true, "sprite": "wall"},
    ".": {"type": "floor", "solid": false, "sprite": "floor"},
    "~": {"type": "water", "solid": false, "damaging": true, "damage": 5, "sprite": "water"},
    "!": {"type": "lava", "solid": false, "damaging": true, "damage": 20, "sprite": "lava"},
    "^": {"type": "spike", "solid": false, "damaging": true, "damage": 10, "sprite": "spike"},
    "P": {"type": "player_spawn", "solid": false, "sprite": "floor"},
    "M": {"type": "monster_spawn", "solid": false, "sprite": "floor"},
    "T": {"type": "treasure", "solid": false, "sprite": "floor"},
    "E": {"type": "exit", "solid": false, "sprite": "exit"},
    "N": {"type": "npc", "solid": false, "sprite": "floor"},
    "B": {"type": "boss", "solid": false, "sprite": "floor"}
  }
}
